border_size=1
usage=map

Dd          , Dd          , Dd          , Dd          , Dd          , Dd          , Dd          , Dd          , Dd          , Dd          , Dd          , Hd          , Hd          , Md          , Md          , Md          , Xu          , Xu          , Xu          , Xu          , Xu          , Xu          , Xu          , Xu          , Xu          , Xu          , Xu          , Xu          , Xu          , Xu          , Uu^Uf       , Uh          , Uh          , Xu          , Uh          , Xu          , Xu          , Xu          , Xu          , Xu          , Xu          , Xu          , Wo          , Wo          , Wo          , Xu          , Xu          , Xu          , Xu          , Xu          , Xu          , Xu          , Xu          , Xu          , Xu          , Xu          , Xu          
Dd          , Dd          , Dd          , Rd          , Dd          , Dd          , Dd          , Dd          , Dd          , Dd          , Dd          , Dd          , Hd          , Md          , Md          , Md          , Xu          , Xu          , Xu          , Xu          , Xu          , Xu          , Xu          , Xu          , Xu          , Xu          , Xu          , Xu          , Xu          , Uu^Uf       , Ur          , Uh          , Uu          , Uu^Uf       , Uu          , Uu^Uf       , Uu^Uf       , Uu          , Xu          , Xu          , Xu          , Xu          , Wo          , Wo          , Xu          , Xu          , Xu          , Xu          , Xu          , Xu          , Xu          , Xu          , Xu          , Xu          , Xu          , Xu          , Xu          
Dd          , Dd          , Dd          , Rd          , Dd          , Dd          , Dd          , Dd          , Dd          , Dd          , Dd          , Dd          , Hd          , Md          , Md          , Md          , Md          , Xu          , Xu          , Xu          , Xu          , Xu          , Xu          , Xu          , Xu          , Xu          , Xu          , Xu          , Uu          , Ur          , Uu          , Uu          , Ur          , Uu^Uf       , Uu          , Uu          , Ur          , Uh          , Uu^Uf       , Xu          , Uu          , Xu          , Ww          , Wo          , Xu          , Xu          , Xu          , Xu          , Xu          , Xu          , Xu          , Xu          , Xu          , Xu          , Xu          , Xu          , Xu          
Dd          , Dd          , Dd          , Rd          , Dd          , Dd          , Dd          , Dd          , Dd          , Dd          , Dd          , Dd          , Hd          , Hd          , Md          , Md          , Md          , Xu          , Xu          , Xu          , Xu          , Xu          , Xu          , Xu          , Uu          , Ur          , Ur^Dr       , Xu          , Xu          , Uh          , Uu^Uf       , Uh          , Uh          , Ur          , Uu          , Ur          , Uu^Uf       , Uu          , Xu          , Ur          , Xu          , Ww^Bw\      , Ww^Bw\      , Ww          , Wwf         , Xu          , Xu          , Xu          , Xu          , Xu          , Xu          , Xu          , Xu          , Xu          , Xu          , Xu          , Xu          
Dd          , Dd          , Dd          , Dd          , Dd          , Dd          , Dd          , Dd^Dc       , Dd          , Dd          , Dd          , Dd          , Dd          , Hd          , Hd          , Md          , Md          , Md          , Xu          , Xu          , Xu          , Xu          , Xu          , Xu          , Ur          , Xu          , Xu          , Xu          , Xu          , Xu          , Xu          , Uu^Uf       , Uh          , Uu^Uf       , Uh          , Uu^Uf       , Uu^Uf       , Uu^Uf       , Xu          , Xu          , Xu          , Ww          , Ww          , Wwf         , Ww^Bw\      , Cud         , Uu          , Xu          , Uu^Vu       , Xu          , Uu          , Xu          , Uu          , Xu          , Xu          , Xu          , Xu          
Dd          , Dd          , Dd          , Rd          , Rd          , Dd          , Dd          , Dd          , Dd          , Dd          , Dd          , Dd          , Dd          , Hd          , Hd          , Md          , Md          , Md          , Xu          , Xu          , Xu          , Xu          , Xu          , Xu          , Uu^Vud      , Ur          , Ur          , Uu          , Xu          , Xu          , Xu          , Xu          , Xu          , Uu^Uf       , Ur          , Uh          , Xu          , Xu          , Xu          , Xu          , Xu          , Ww          , Ww          , Ww          , Ww          , Cud         , Uu          , Uu          , Uu          , Uu          , Uu          , Uu          , Uu          , Xu          , Xu          , Xu          , Xu          
Dd          , Dd          , Dd          , Dd          , Rd          , Dd^Do       , Dd          , Dd          , Rd          , Dd          , Dd          , Dd          , Dd          , Dd          , Dd          , Hd          , Xu          , Xu          , Xu          , Xu          , Xu          , Xu          , Qxu         , Qxu         , Qxu         , Qxu         , Uu          , Xu          , Xu          , Xu          , Xu          , Xu          , Xu          , Xu          , Ur          , Xu          , Xu          , Xu          , Xu          , Xu          , Xu          , Xu          , Ww          , Ww          , Ww          , Uu          , Uu          , Uu          , Uu          , Uu          , Uu          , Uu          , Uu          , Uu^Vu       , Uu          , Xu          , Xu          
Dd          , Dd          , Dd^Dc       , Dd          , Dd          , Rd          , 1 Dd        , Rd          , Dd          , Rd          , Rd          , Dd          , Dd          , Dd          , Dd          , Dd          , Xu          , Xu          , Xu          , Xu          , Qxu         , Qxu         , Qxu         , Qxu         , Qxu         , Qxu         , 2 Kud       , Uu          , Uu          , Xu          , Xu          , Xu          , Xu          , Xu          , Xu          , Uu          , Ur          , Xu          , Xu          , Xu          , Xu          , Ww          , Ww          , Ww          , Wwf         , Uu          , Uu          , Uu          , Uu          , Uu          , Uu          , Uu          , Uu          , Uu          , Uu          , Xu          , Xu          
Dd          , Dd          , Dd          , Dd          , Dd          , Dd          , Dd          , Dd          , Dd          , Dd          , Dd          , Dd          , Ur          , Ur          , Ur          , Cud         , Qxu         , Xu          , Qxu         , Qxu         , Qxu         , Qxu         , Qxu         , Qxu         , Xu          , Xu          , Cud         , Cud         , Uu          , Uu^Vud      , Uu^Vud      , Xu          , Xu          , Xu          , Xu          , Uu^Uf       , Uu          , Xu          , Xu          , Xu          , Xu          , Ww          , Ww^Bw/      , Ww^Bw/      , Ww          , Cud         , Uu          , Uu          , Uu^Vu       , Uu          , Uu          , Uu          , Uu          , Uu          , Uu          , Xu          , Xu          
Hd          , Dd          , Hd          , Dd          , Hd          , Hd          , Hd          , Hd          , Hd          , Hd          , Hd          , Dd          , Ur          , Ur          , Ur          , Uu^Uf       , Ur          , Qxu         , Qxu         , Qxu         , Qxu         , Qxu         , Qxu         , Xu          , Xu          , Xu          , Xu          , Uu          , Uu          , Uu          , Xu          , Xu          , Xu          , Xu          , Xu          , Xu          , Xu          , Ur          , Ur          , Uh          , Uu          , Uu          , Ww          , Ww          , Ww          , Ww          , Uu          , Uu          , Uu          , Uu          , Uu          , Uu          , Uu          , Uu^Vu       , Uu          , Uu          , Xu          
Hd          , Hd          , Hd          , Hd          , Md          , Md          , Md          , Md          , Md          , Md          , Md          , Cud         , Ur          , Ur          , Uu^Uf       , Ur          , Ur          , Ur          , Qxu^Bs\     , Qxu         , Cud         , Qxu         , Xu          , Xu          , Xu          , Xu          , Xu          , Ur          , Uu^Vud      , Xu          , Xu          , Xu          , Xu          , Xu          , Wog         , Xu          , Xu          , Xu          , Uh          , Uu          , Ww          , Xu          , Xu          , Ww          , Ww          , Ww          , Ww          , Uu          , Uu          , Uu          , Cud         , Cud         , Cud         , Uu          , Uu          , Uu          , Xu          
Md          , Md          , Md          , Md          , Md          , Md          , Md          , Md          , Md          , Md          , Xu          , Xu          , Xu          , Qxu         , Qxu         , Ur          , Qxu^Bs\     , Qxu^Bs\     , Ur          , Uu          , Uu          , Uu^Uf       , Uu^Uf       , Uu^Uf       , Uu          , Ur          , Uu          , Ur          , Xu          , Xu          , Xu          , Xu          , Xu          , Ww^Vm       , Xu          , Xu          , Xu          , Xu          , Xu          , Ww^Bw\      , Ww^Bw\      , Ww          , Ww          , Ww          , Ww          , Ww          , Ww          , Uu          , Uu^Vu       , Uu          , Cud         , 3 Kud       , Cud         , Uu          , Uu^Vu       , Uu          , Xu          
Md          , Md          , Md          , Md          , Md          , Md          , Md          , Md          , Xu          , Xu          , Xu          , Xu          , Qxu         , Qxu         , Qxu         , Qxu         , Cud         , Ur          , Ur          , Ur          , Ur          , Ur          , Uu          , Uu          , Uu          , Uu^Uf       , Xu          , Xu          , Xu          , Xu          , Xu          , Xu          , Xu          , Wwf         , Ww          , Uu          , Uu          , Xu          , Xu          , Ww          , Ww          , Wwf         , Ww^Bw\      , Ww          , Ww          , Ww          , Uu          , Uu          , Uu          , Uu          , Uu          , Cud         , Uu          , Uu          , Uu          , Uu          , Xu          
Xu          , Md          , Md          , Md          , Xu          , Md          , Xu          , Xu          , Xu          , Xu          , Qxu         , Qxu         , Qxu         , Qxu         , Uu          , Qxu^Bs/     , Qxu         , Ur          , Uu^Uf       , Uu          , Uu          , Ur          , Ur          , Ur          , Uu^Uf       , Ur          , Uu^Vud      , Xu          , Xu          , Xu          , Xu          , Xu          , Xu          , Xu          , Xu          , Ww          , Wwf         , Ww          , Ww          , Ww          , Ww          , Wwf         , Uu          , Ww^Bw\      , Cud         , Cud         , Uu          , Uu          , Uu          , Uu          , Uu          , Uu          , Uu          , Uu          , Uu          , Xu          , Xu          
Xu          , Xu          , Xu          , Xu          , Xu          , Xu          , Qxu         , Qxu         , Qxu         , Qxu         , Qxu         , Qxu         , Qxu         , Qxu         , Uu          , Xu          , Xu          , Xu          , Xu          , Ur          , Ur          , Ur          , Uu          , Ur          , Ur          , Ur          , Uu          , Uh          , Uu^Dr       , Xu          , Xu          , Xu          , Xu          , Xu          , Xu          , Xu          , Xu          , Ww          , Wwf         , Ww          , Wwf         , Uu          , Uu          , Uu          , Uu          , Uu          , Uu          , Uu          , Uu          , Uu          , Uu          , Uu          , Uu          , Uu          , Uu          , Xu          , Xu          
Xu          , Xu          , Xu          , Xu          , Xu          , Xu          , Qxu         , Qxu         , Qxu         , Qxu         , Uu          , Qxu         , Uu          , Uu          , Ur          , Ur          , Uu          , Xu          , Ur          , Uu          , Xu          , Ur          , Uu^Uf       , Ur          , Ur          , Ur          , Ur          , Ur          , Uh          , Uh          , Uu^Vud      , Xu          , Xu          , Xu          , Xu          , Xu          , Xu          , Uu          , Xu          , Ww          , Ww          , Ww          , Ww          , Uu          , Uu          , Uu^Vu       , Xu          , Xu          , Uu          , Uu          , Uu^Vu       , Uu          , Uu          , Uu          , Uu          , Xu          , Xu          
Xu          , Xu          , Xu          , Xu          , Xu          , Xu          , Qxu         , Qxu         , Qxu         , Uu^Vud      , Uu          , Uu          , Uu          , Uu          , Xu          , Xu          , Xu          , Ur          , Xu          , Xu          , Xu          , Xu          , Xu          , Uu^Uf       , Uu          , Uu          , Uu          , Ur          , Uh          , Uh^Dr       , Xu          , Xu          , Xu          , Xu          , Xu          , Xu          , Xu          , Ur          , Xu          , Xu          , Xu          , Ww          , Ww          , Xu          , Ww          , Xu          , Xu          , Uu          , Uu          , Uu          , Uu          , Uu          , Xu          , Uu          , Uu          , Uu^Vu       , Xu          
Xu          , Xu          , Xu          , Xu          , Xu          , Qxu         , Qxu         , Qxu         , Xu          , Uu          , Uu          , Uu          , Cud         , Cud         , Xu          , Xu          , Xu          , Xu          , Xu          , Xu          , Xu          , Xu          , Xu          , Xu          , Xu          , Uh          , Uu^Uf       , Ur          , Uh          , Uh^Dr       , Xu          , Xu          , Xu          , Xu          , Uu^Vud      , Xu          , Ur          , Ur          , Xu          , Xu          , Xu          , Ww          , Ww          , Ww          , Ww          , Wwf         , Wwf         , Uu          , Uu          , Cud         , Xu          , Xu          , Ww          , Cud         , Uu          , Uu          , Xu          
Xu          , Xu          , Xu          , Xu          , Xu          , Qxu         , Qxu         , Qxu         , Xu          , Uu          , Uu          , Uu          , Cud         , Cud         , Xu          , Xu          , Xu          , Xu          , Xu          , Xu          , Xu          , Xu          , Xu          , Xu          , Xu          , Xu          , Xu          , Uh          , Uh^Dr       , Ur          , Xu          , Xu          , Uh^Dr       , Uh^Dr       , Uh          , Uh          , Uu^Uf       , Xu          , Xu          , Xu          , Xu          , Xu          , Xu          , Ww          , Ww          , Ww          , Wwf         , Ww          , Ww          , Ww          , Ww          , Ww          , Ww          , Ww          , Wwf         , Wwf         , Wwf         
Xu          , Xu          , Xu          , Xu          , Xu          , Qxu         , Qxu         , Qxu         , Xu          , Uu          , Uu          , Uu          , Uu          , Cud         , Xu          , Xu          , Xu          , Xu          , Xu          , Xu          , Xu          , Xu          , Xu          , Xu          , Xu          , Xu          , Xu          , Xu          , Xu          , Uh^Dr       , Xu          , Xu          , Uh^Dr       , Uh          , Uu          , Uu^Uf       , Ur          , Uu^Uf       , Ur          , Xu          , Xu          , Xu          , Xu          , Xu          , Xu          , Ww          , Uu          , Ww          , Xu          , Ww          , Ww          , Xu          , Ww          , Ww          , Ww          , Ww          , Ww          
Xu          , Xu          , Uu^Vud      , Xu          , Xu          , Qxu         , Qxu         , Xu          , Xu          , Uu^Vud      , Uu          , Ur          , Ur          , Uu          , Qxu         , Xu          , Qxu         , Qxu         , Qxu         , Xu          , Xu          , Xu          , Xu          , Xu          , Xu          , Xu          , Xu          , Xu          , Xu          , Xu          , Xu          , Xu          , Uu^Dr       , Uu^Uf       , Uu          , Ur          , Ur          , Ur          , Uu          , Ur          , Uu^Uf       , Xu          , Xu          , Xu          , Xu          , Xu          , Uu          , Uu          , Xu          , Xu          , Uu          , Wwf         , 4 Khw       , Wwf         , Xu          , Ww          , Xu          
Xu          , Xu          , Uu          , Xu          , Xu          , Qxu         , Qxu         , Qxu         , Xu          , Xu          , Qxu         , Ur          , Qxu^Bs\     , Qxu         , Qxu         , Qxu         , Qxu         , Qxu         , Qxu         , Xu          , Xu          , Xu          , Xu          , Xu          , Xu          , Xu          , Uh          , Xu          , Xu          , Xu          , Xu          , Xu          , Ur          , Ur          , Uu^Uf       , Uu          , Ur          , Ur          , Ur          , Uu^Uf       , Ur          , Ur          , Uu^Vud      , Xu          , Xu          , Xu          , Ur          , Xu          , Xu          , Xu          , Xu          , Uu          , Chw         , Chw         , Xu          , Xu          , Xu          
Xu          , Xu          , Xu          , Uu          , Uu          , Qxu         , Qxu         , Qxu         , Qxu         , Qxu         , Qxu         , Qxu         , Qxu         , Ur          , Qxu         , Qxu         , Qxu         , Qxu         , Xu          , Xu          , Uh          , Xu          , Uh          , Uh          , Uh          , Uh          , Uh          , Uh          , Uh          , Xu          , Xu          , Xu          , Ur          , Xu          , Xu          , Uu          , Uu^Uf       , Ur          , Ur          , Ur          , Ur          , Uu          , Ur          , Ur          , Uu          , Ur          , Xu          , Xu          , Xu          , Xu          , Xu          , Xu          , Xu          , Xu          , Xu          , Xu          , Xu          
Xu          , Xu          , Xu          , Xu          , Xu          , Xu          , Xu          , Qxu         , Qxu         , Qxu         , Qxu         , Qxu         , Qxu         , Qxu^Bs|     , Cud^Sco     , Xu          , Xu          , Xu          , Uu          , Uu          , Uu          , Uu          , Uu          , Uh          , Uu          , Uh          , Uu          , Uh          , Uu          , Uu          , Uu          , Uu          , Xu          , Xu          , Xu          , Xu          , Xu          , Ur          , Uu          , Ur          , Ur          , Ur          , Ur          , Ur          , Xu          , Xu          , Xu          , Xu          , Xu          , Xu          , Xu          , Xu          , Xu          , Xu          , Xu          , Xu          , Xu          
Xu          , Xu          , Xu          , Xu          , Xu          , Xu          , Xu          , Xu          , Xu          , Qxu         , Xu          , Xu          , Cud^Sco     , Ur          , Ur          , Uu          , Ur          , Uu          , Ur          , Uu          , Uu          , Uu          , Uu          , Uu          , Uu          , Uu          , Uu          , Uu          , Uu          , Uu          , Uu          , Uu          , Uh          , Xu          , Xu          , Xu          , Xu          , Xu          , Xu          , Ur          , Ur          , Ur          , Uu          , Ur          , Xu          , Xu          , Xu          , Xu          , Xu          , Xu          , Xu          , Xu          , Xu          , Xu          , Xu          , Xu          , Xu          
Xu          , Xu          , Xu          , Xu          , Xu          , Xu          , Xu          , Xu          , Xu          , Xu          , Xu          , Xu          , Xu          , Xu          , Xu          , Ur          , Uu          , Ur          , Uu          , Uu          , Uu          , Uu          , Uu          , Uu          , Uu          , Uu          , Uu          , Uu          , Uu          , Uu          , Uu          , Uu          , Uu          , Uu          , Xu          , Xu          , Xu          , Xu          , Uu          , Ur          , Ur          , Ur          , Ur          , Uu^Uf       , Xu          , Xu          , Xu          , Xu          , Xu          , Xu          , Xu          , Xu          , Xu          , Xu          , Xu          , Xu          , Xu          
Xu          , Xu          , Xu          , Xu          , Xu          , Xu          , Xu          , Xu          , Xu          , Xu          , Xu          , Xu          , Xu          , Xu          , Xu          , Xu          , Xu          , Xu          , Xu          , Uh          , Uh          , Uh          , Uh          , Uu          , Uh          , Uu          , Xu          , Uu          , Uh          , Uu          , Uu          , Uu          , Uu          , Uu          , Uu          , Ur          , Ur          , Xu          , Ur          , Uu          , Ur          , Ur          , Ur          , Uu^Uf       , Xu          , Xu          , Xu          , Xu          , Xu          , Xu          , Xu          , Xu          , Xu          , Xu          , Xu          , Xu          , Xu          
Xu          , Xu          , Xu          , Xu          , Xu          , Xu          , Xu          , Xu          , Xu          , Xu          , Xu          , Xu          , Xu          , Xu          , Xu          , Xu          , Xu          , Xu          , Xu          , Xu          , Xu          , Xu          , Xu          , Uh          , Xu          , Xu          , Xu          , Xu          , Xu          , Uh          , Uh          , Uu          , Uu          , Uu          , Xu          , Xu          , Xu          , Ur          , Xu          , Ur          , Ur          , Uu          , Uu          , Ur          , Xu          , Xu          , Xu          , Xu          , Xu          , Xu          , Xu          , Xu          , Xu          , Xu          , Xu          , Xu          , Xu          
Xu          , Xu          , Xu          , Xu          , Xu          , Xu          , Xu          , Xu          , Xu          , Xu          , Xu          , Xu          , Xu          , Xu          , Xu          , Xu          , Xu          , Xu          , Xu          , Xu          , Xu          , Xu          , Xu          , Xu          , Xu          , Xu          , Xu          , Xu          , Xu          , Xu          , Xu          , Uh          , Xu          , Xu          , Xu          , Xu          , Xu          , Xu          , Xu          , Ur          , Ur          , Ur          , Uu          , Ur          , Xu          , Xu          , Xu          , Xu          , Xu          , Xu          , Xu          , Xu          , Xu          , Xu          , Xu          , Xu          , Xu          
Xu          , Xu          , Xu          , Xu          , Xu          , Xu          , Xu          , Xu          , Xu          , Xu          , Xu          , Xu          , Xu          , Xu          , Xu          , Xu          , Xu          , Xu          , Xu          , Xu          , Xu          , Xu          , Xu          , Xu          , Xu          , Xu          , Xu          , Xu          , Xu          , Xu          , Xu          , Xu          , Xu          , Xu          , Xu          , Xu          , Xu          , Xu          , Xu          , Ur          , Uu^Uf       , Ur          , Ur          , Uu^Vud      , Xu          , Xu          , Xu          , Xu          , Xu          , Xu          , Xu          , Xu          , Xu          , Xu          , Xu          , Xu          , Xu          
Xu          , Xu          , Xu          , Xu          , Xu          , Xu          , Xu          , Xu          , Xu          , Xu          , Xu          , Xu          , Xu          , Xu          , Xu          , Xu          , Xu          , Xu          , Xu          , Xu          , Xu          , Xu          , Xu          , Xu          , Xu          , Xu          , Xu          , Xu          , Xu          , Xu          , Xu          , Xu          , Xu          , Xu          , Xu          , Xu          , Xu          , Xu          , Xu          , Uu          , Uu          , Ur          , Ur          , Ur          , Xu          , Xu          , Xu          , Xu          , Xu          , Xu          , Xu          , Xu          , Xu          , Xu          , Xu          , Xu          , Xu          
Xu          , Xu          , Xu          , Xu          , Xu          , Xu          , Xu          , Xu          , Xu          , Xu          , Xu          , Xu          , Xu          , Xu          , Xu          , Xu          , Xu          , Xu          , Xu          , Xu          , Xu          , Xu          , Xu          , Xu          , Xu          , Xu          , Xu          , Xu          , Xu          , Xu          , Xu          , Xu          , Xu          , Xu          , Xu          , Xu          , Xu          , Xu          , Xu          , Uu          , Ur          , Ur          , Ur          , Ur          , Xu          , Xu          , Xu          , Xu          , Xu          , Xu          , Xu          , Xu          , Xu          , Xu          , Xu          , Xu          , Xu          
