border_size=1
usage=map

Xu          , Xu          , Xu          , Xu          , Xu          , Xu          , Xu          , Xu          , Xu          , Xu          , Xu          , Xu          , Xu          , Xu          , Xu          , Xu          , Xu          , Xu          , Xu          , Xu          , Xu          , Xu          , Xu          , Xu          , Xu          , Xu          , Xu          , Xu          , Xu          , Xu          , Xu          , Xu          , Xu          , Xu          , Xu          , Xu          , Xu          , Xu          , Xu          , Xu          , Xu          , Xu          , Xu          , Xu          , Xu          , Uu          , Ur          , Ur          , Uu          , Uu^Uf       , Xu          , Xu          , Xu          , Xu          , Xu          , Xu          , Xu          , Xu          
Xu          , Xu          , Xu          , Xu          , Xu          , Xu          , Xu          , Xu          , Xu          , Xu          , Xu          , Xu          , Xu          , Xu          , Xu          , Xu          , Xu          , Xu          , Xu          , Xu          , Xu          , Xu          , Xu          , Xu          , Xu          , Xu          , Xu          , Xu          , Xu          , Xu          , Xu          , Xu          , Xu          , Xu          , Xu          , Xu          , Xu          , Xu          , Xu          , Xu          , Xu          , Xu          , Xu          , Xu          , Xu          , Uu          , Uu          , 1 Ur        , Ur          , Uu^Vud      , Xu          , Xu          , Xu          , Xu          , Xu          , Xu          , Xu          , Xu          
Xu          , Xu          , Xu          , Xu          , Xu          , Xu          , Uu          , Uu^Vud      , Uu          , Xu          , Xu          , Xu          , Xu          , Xu          , Xu          , Xu          , Xu          , Xu          , Xu          , Xu          , Xu          , Xu          , Xu          , Uu^Vud      , Ur          , Ur          , Ur          , Uu          , Ur          , Xu          , Xu          , Xu          , Xu          , Xu          , Xu          , Xu          , Xu          , Xu          , Xu          , Xu          , Xu          , Xu          , Xu          , Xu          , Xu          , Ur          , Ur          , Ur          , Uu^Uf       , Uu^Uf       , Xu          , Xu          , Xu          , Xu          , Xu          , Xu          , Xu          , Xu          
Xu          , Xu          , Xu          , Xu          , Uu          , Uu          , Uu          , Uu          , Ur          , Uu          , Uu          , Xu          , Uu          , Xu          , Uu^Vud      , Xu          , Uu          , Xu          , Ur          , Uu^Vud      , Ur          , Xu          , Ur          , Ur          , Uu          , Ur          , Uu          , Uu          , Uu          , Ur          , Uu          , Uu^Vud      , Qxu         , Xu          , Xu          , Xu          , Xu          , Xu          , Xu          , Xu          , Xu          , Xu          , Xu          , Xu          , Xu          , Uu^Uf       , Ur          , Ur          , Ur          , Ur          , Xu          , Xu          , Xu          , Xu          , Xu          , Xu          , Xu          , Xu          
Xu          , Xu          , Uu          , Uu          , Uu^Vud      , Uu          , Ur          , Ur          , Uu          , Ur          , Uu          , Uu          , Uu          , Uu          , Uu          , Uu^Dr       , Uu^Dr       , Uu          , Uu          , Ur          , Ur          , Ur          , Xu          , Xu          , Xu          , Xu          , Xu          , Uu          , Xu          , Uu          , Cud         , Cud         , Qxu^Bs\     , Qxu         , Xu          , Xu          , Xu          , Xu          , Xu          , Xu          , Xu          , Xu          , Xu          , Xu          , Xu          , Uu^Uf       , Ur          , Ur          , Uu          , Ur          , Xu          , Xu          , Xu          , Xu          , Xu          , Xu          , Xu          , Xu          
Xu          , Xu          , Uu          , Uu          , Cud         , Cud         , Cud         , Cud         , Cud         , Ur          , Ur          , Xos         , Uu          , Xos         , Uu          , Uu^Dr       , Uu^Dr       , Xos         , Uu          , Xos         , Uu          , Uu          , Uu          , Uu          , Xu          , Xu          , Xu          , Uu          , Qxu         , Qxu         , Qxu         , Qxu^Bs\     , Uu          , Uu          , Uu          , Xu          , Xu          , Xu          , Xu          , Xu          , Xu          , Xu          , Xu          , Xu          , Xu          , Uu^Uf       , Ur          , Ur          , Ur          , Ur          , Xu          , Xu          , Xu          , Xu          , Xu          , Xu          , Xu          , Xu          
Xu          , Xu          , Uu          , Uu          , Cud         , Uu          , Kud         , Uu          , Cud         , Uu          , Uu          , Ur          , Ur          , Ur          , Ur          , Uu          , Ur          , Ur          , Ur          , Uu          , Ur          , Ur          , Ur          , Uu          , Uu          , Cud         , Ur          , Uu^Vud      , Qxu         , Qxu         , Qxu         , Qxu         , Xu          , Uu          , Ur          , Uu          , Xu          , Xu          , Xu          , Xu          , Xu          , Xu          , Xu          , Xu          , Xu          , Uu^Vud      , Ur          , Uu          , Uu          , Ur          , Xu          , Xu          , Xu          , Xu          , Xu          , Xu          , Xu          , Xu          
Xu          , Xu          , Uu          , Uu          , Cud         , Uu          , Cud         , Uu          , Cud         , Uu          , Uu^Dr       , Ur          , Ur          , Ur          , Uu          , Ur          , Uu          , Ur          , Ur          , Ur          , Uu          , Uu          , Ur          , Ur          , Uu          , Xu          , Xu          , Ur          , Qxu^Bs\     , Qxu         , Xu          , Qxu         , Xu          , Xu          , Xu          , Ur          , Ur          , Xu          , Xu          , Xu          , Xu          , Xu          , Xu          , Xu          , Xu          , Ur          , Ur          , Ur          , Uu          , Ur          , Xu          , Xu          , Xu          , Xu          , Xu          , Xu          , Xu          , Xu          
Xu          , Xu          , Uu^Vud      , Uu          , Uu          , Cud         , Uu          , Cud         , Ur          , Ur          , Uu          , Uu^Dr       , Uu^Dr       , Xos         , Uu          , Xos         , Uu          , Xos         , Uu          , Xos         , Ur          , Ur          , Ur          , Ur          , Uu          , Cud         , Qxu^Bs\     , Qxu         , Xu          , Uu          , Uu          , Xu          , Xu          , Xu          , Xu          , Uu^Vud      , Uu          , Ur          , Uu          , Xu          , Xu          , Xu          , Xu          , Xu          , Xu          , Ur          , Ur          , Ur          , Ur          , Uu          , Xu          , Xu          , Xu          , Xu          , Xu          , Xu          , Xu          , Xu          
Xu          , Xu          , Xu          , Uu          , Ur          , Uu          , Ur          , Ur          , Uu          , Uu          , Cud         , Uu^Dr       , Uu          , Uu          , Uu^Vud      , Uu          , Uu          , Uu          , Uu          , Uu          , Uu          , Ur          , Uu          , Uu          , Cud         , Qxu         , Qxu         , Qxu^Bs\     , Ur          , Xu          , Ur          , Xu          , Xu          , Xu          , Xu          , Xu          , Xu          , Uu          , Xu          , Uu          , Uu          , Xu          , Xu          , Xu          , Xu          , Uu          , Uu          , Ur          , Ur          , Uu          , Xu          , Xu          , Xu          , Xu          , Xu          , Xu          , Xu          , Xu          
Xu          , Xu          , Uu          , Uu          , Ur          , Ur          , Uu          , Uu          , Cud         , Uu          , Uu          , Xu          , Xu          , Xu          , Xu          , Xu          , Xu          , Xu          , Cud         , Uu          , Qxu         , Uu          , Cud         , Ur          , Qxu         , Qxu^Bs\     , Uu          , Uu          , Uu          , Ur          , Uu          , Xu          , Xu          , Xu          , Xu          , Xu          , Xu          , Xu          , Xu          , Xu          , Kud         , Xu          , Xu          , Xu          , Xu          , Ur          , Uu          , Ur          , Ur          , Uu          , Xu          , Xu          , Xu          , Xu          , Xu          , Xu          , Xu          , Xu          
Xu          , Xu          , Ur          , Ur          , Xu          , Xu          , Xu          , Xu          , Xu          , Uu          , Uu          , Ur          , Ur          , Xu          , Xu          , Xu          , Xu          , Xu          , Xu          , Qxu^Bs\     , Ur          , Qxu         , Uu          , Qxu^Bs\     , Cud         , Qxu^Bs/     , Uu          , Ur          , Uu          , Ur          , Ur          , Uu          , Uu          , Cud         , Uu          , Xu          , Xu          , Xu          , Xu          , Xu          , Cud         , Cud         , Cud         , Xu          , Xu          , Ur          , Ur          , Ur          , Ur          , Ur          , Uu          , Xu          , Xu          , Xu          , Xu          , Xu          , Xu          , Xu          
Uu          , Uu          , Ur          , Uu          , Xu          , Xu          , Xu          , Xu          , Xu          , Xu          , Xu          , Ur          , Ur          , Uu^Vud      , Xu          , Xu          , Xu          , Xu          , Qxu         , Qxu         , Xu          , Ur          , Qxu         , Qxu^Bs\     , Cud         , Qxu         , Uu          , Ur          , Xu          , Uu          , Ur          , Uu          , Uu          , Uu          , Uu          , Uu          , Uu          , Uu^Vud      , Uu          , Cud         , Uu          , Cud         , Ur          , Uu          , Ur          , Ur          , Ur          , Ur          , Ur          , Ur          , Xu          , Uu          , Uu          , Xu          , Xu          , Xu          , Xu          , Xu          
Ur          , Ur          , Xu          , Xu          , Xu          , Xu          , Xu          , Xu          , Xu          , Xu          , Xu          , Xu          , Ur          , Ur          , Uu          , Xu          , Xu          , Xu          , Qxu         , Qxu         , Uu          , Ur          , Qxu         , Qxu         , Qxu         , Qxu^Bs\     , Uu          , Uu          , Uu^Vud      , Uu          , Uu          , Ur          , Ur          , Ur          , Ur          , Ur          , Ur          , Ur          , Uu          , Uu          , Ur          , Uu          , Uu          , Uu          , Dd          , Uu          , Dd          , Ur          , Ur          , Xu          , Cud         , Xu          , Cud         , Xu          , Xu          , Xu          , Xu          , Xu          
Uu          , Uu          , Xu          , Xu          , Xu          , Xu          , Xu          , Xu          , Xu          , Xu          , Xu          , Xu          , Xu          , Ur          , Ur          , Ur          , Cud         , Xu          , Uu          , Qxu^Bs/     , Xu          , Cud         , Ur          , Ur          , Ur          , Qxu^Bs/     , Qxu         , Xu          , Xu          , Xu          , Xu          , Uu          , Uu          , Uu          , Uu          , Uu          , Uu          , Uu          , Xu          , Ur          , Uu          , Ur          , Dd          , Dd          , Dd          , Dd          , Dd          , Dd          , Dd          , Xu          , Cud         , Cud         , Xu          , Xu          , Xu          , Xu          , Dd          , Xu          
Xu          , Xu          , Xu          , Xu          , Xu          , Xu          , Xu          , Xu          , Xu          , Xu          , Xu          , Xu          , Xu          , Xu          , Xu          , Ur          , Xu          , Uu          , Xu          , Qxu         , Qxu         , Qxu         , Xu          , Xu          , Uu          , Qxu         , Qxu         , Xu          , Xu          , Xu          , Xu          , Cud         , Uu          , Uu          , Xu          , Uu          , Uu          , Uu          , Uu          , Ur          , Uh          , Uu          , Dd          , Dd          , Dd          , Dd          , Dd          , Dd          , Dd          , Dd          , Dd          , Cud         , Dd          , Xu          , Dd          , Dd          , Dd          , Dd          
Xu          , Xu          , Xu          , Xu          , Xu          , Xu          , Xu          , Xu          , Xu          , Xu          , Xu          , Xu          , Xu          , Xu          , Xu          , Uu          , Xu          , Xu          , Xu          , Xu          , Xu          , Qxu         , Qxu         , Xu          , Qxu         , Qxu^Bs\     , Ur          , Xu          , Xu          , Xu          , Xu          , Xu          , Xu          , Xu          , Xu          , Xu          , Xu          , Uu          , Uu          , Uu          , Dd          , Dd          , Dd          , Dd          , Dd          , Dd          , Dd          , Dd          , Dd          , Ce          , Dd          , Dd          , Dd          , Dd          , Dd          , Dd          , Dd          , Dd          
Xu          , Xu          , Xu          , Xu          , Xu          , Xu          , Xu          , Xu          , Xu          , Xu          , Xu          , Xu          , Xu          , Xu          , Cud         , Uu          , Ur          , Xu          , Xu          , Xu          , Xu          , Xu          , Xu          , Qxu         , Qxu         , Qxu         , Qxu         , Ur          , Xu          , Xu          , Xu          , Xu          , Xu          , Xu          , Xu          , Xu          , Ur          , Uh          , Uu          , Uu          , Dd          , Dd          , Dd          , Dd          , Dd          , Dd          , Dd          , Ce          , Dd          , Dd          , Ce          , Dd          , Dd          , Dd          , Dd          , Dd^Vdt      , Dd          , Dd          
Xu          , Xu          , Xu          , Xu          , Xu          , Xu          , Xu          , Xu          , Xu          , Xu          , Xu          , Xu          , Xu          , Xu          , Xu          , Ur          , Ur          , Ur          , Ur          , Xu          , Ur          , Ur          , Qxu^Bs\     , Qxu         , Ur          , Xu          , Qxu         , Uu          , Xu          , Xu          , Xu          , Xu          , Xu          , Xu          , Ur          , Ur          , Qxu         , Ur          , Ur          , Ur          , Uu          , Dd          , Dd          , Dd          , Dd          , Dd          , Dd          , Dd          , Dd          , Ce          , 2 Ke        , Ce          , Dd          , Ce          , Dd          , Dd          , Dd          , Dd          
Xu          , Xu          , Xu          , Xu          , Xu          , Xu          , Xu          , Xu          , Xu          , Xu          , Xu          , Xu          , Xu          , Xu          , Xu          , Xu          , Xu          , Xu          , Uu^Vud      , Ur          , Uu          , Qxu         , Qxu         , Ur          , Xu          , Uu          , Uu          , Ur          , Ur          , Xu          , Ur          , Xu          , Ur          , Ur          , Qxu         , Qxu         , Qxu         , Qxu         , Qxu^Bs/     , Uu          , Xu          , Xu          , Cud         , Cud         , Cud         , Dd          , Dd          , Ce          , Dd          , Ce          , Ce          , Ce          , Dd          , Dd          , Dd          , Dd          , Dd          , Dd          
Xu          , Xu          , Xu          , Xu          , Xu          , Xu          , Xu          , Xu          , Xu          , Xu          , Xu          , Xu          , Xu          , Xu          , Xu          , Xu          , Xu          , Xu          , Xu          , Xu          , Xu          , Uu          , Qxu         , Qxu         , Qxu         , Xu          , Xu          , Ur          , Ur          , Ur          , Uu^Vud      , Ur          , Uu          , Qxu         , Qxu         , Qxu         , Ur          , Ur          , Qxu         , Qxu         , Xu          , Xu          , Xu          , Cud         , Cud         , Dd          , Dd          , Dd          , Dd          , Dd          , Dd          , Dd          , Dd          , Ce          , Dd          , Dd          , Dd          , Dd          
Xu          , Xu          , Xu          , Xu          , Xu          , Xu          , Xu          , Xu          , Xu          , Xu          , Xu          , Xu          , Xu          , Xu          , Xu          , Xu          , Xu          , Xu          , Xu          , Xu          , Xu          , Ur          , Ur          , Qxu         , Ur          , Qxu         , Qxu         , Qxu         , Uu          , Ur          , Qxu         , Ur          , Qxu         , Qxu^Bs\     , Ur          , Qxu^Bs/     , Qxu         , Qxu         , Qxu         , Qxu         , Xu          , Xu          , Xu          , Xu          , Xu          , Dd          , Dd          , Dd          , Dd          , Dd          , Dd          , Ce          , Dd          , Dd          , Dd          , Dd          , Dd          , Dd          
Xu          , Xu          , Xu          , Xu          , Xu          , Xu          , Xu          , Xu          , Xu          , Xu          , Xu          , Xu          , Xu          , Xu          , Xu          , Xu          , Xu          , Xu          , Xu          , Xu          , Xu          , Xu          , Xu          , Ur          , Xu          , Uu          , Uu          , Qxu^Bs/     , Qxu         , Qxu         , Qxu         , Qxu         , Qxu         , Qxu         , Qxu         , Qxu         , Xu          , Qxu         , Qxu         , Qxu         , Xu          , Xu          , Xu          , Xu          , Xu          , Xu          , Dd          , Dd          , Dd          , Dd          , Dd          , Dd          , Dd          , Dd          , Dd          , Dd          , Dd          , Dd          
Xu          , Xu          , Xu          , Xu          , Xu          , Xu          , Xu          , Xu          , Xu          , Xu          , Xu          , Xu          , Xu          , Xu          , Xu          , Xu          , Xu          , Xu          , Xu          , Xu          , Xu          , Xu          , Xu          , Xu          , Xu          , Xu          , Xu          , Cud         , Xu          , Qxu         , Qxu         , Qxu         , Xu          , Xu          , Xu          , Xu          , Xu          , Qxu         , Qxu         , Qxu         , Qxu         , Qxu         , Xu          , Xu          , Xu          , Xu          , Dd          , Dd          , Dd          , Dd^Vdt      , Dd          , Dd          , Dd          , Dd          , Dd          , Dd          , Dd          , Dd          
Xu          , Xu          , Xu          , Xu          , Xu          , Xu          , Xu          , Xu          , Xu          , Xu          , Xu          , Xu          , Xu          , Xu          , Xu          , Xu          , Xu          , Xu          , Xu          , Xu          , Xu          , Xu          , Xu          , Xu          , Xu          , Xu          , Xu          , Xu          , Xu          , Xu          , Xu          , Qxu         , Xu          , Xu          , Xu          , Xu          , Xu          , Xu          , Qxu         , Qxu         , Qxu         , Xu          , Xu          , Xu          , Xu          , Xu          , Dd          , Dd          , Dd          , Dd          , Dd          , Dd          , Dd          , Dd          , Dd          , Dd^Vdt      , Dd          , Dd          
Xu          , Xu          , Xu          , Xu          , Xu          , Xu          , Xu          , Xu          , Xu          , Xu          , Xu          , Xu          , Xu          , Xu          , Xu          , Xu          , Xu          , Xu          , Xu          , Xu          , Xu          , Xu          , Xu          , Xu          , Xu          , Xu          , Xu          , Xu          , Xu          , Xu          , Xu          , Xu          , Xu          , Xu          , Xu          , Xu          , Xu          , Xu          , Qxu         , Qxu         , Qxu         , Xu          , Xu          , Xu          , Xu          , Xu          , Dd          , Dd          , Dd          , Dd          , Dd          , Dd          , Dd          , Dd          , Dd          , Dd          , Dd          , Dd          
