border_size=1
usage=map

Uu          , Uu          , Uu          , Uu          , Uu          , Uu          , Uu          , Uu          , Uu          , Xu          , Ms          , Ms          , Ms          , Ms          , Ms          , Gg          , Ha          , Ha          , Ha          , Gg          , Gg          , Gg          , Gg          , Gg          , Rd          , Gg          , Gg          , Gg          , Gg          , Gg          , Gg          , Gg          , Gg          , Gg          , Aa          , Aa          , Ha          , Ms          , Ms          , Ms          , Ms          , Ms          , Ms          , Ms          , Ms          , Ms          
Uu          , Uu          , Ce          , Ce          , Ce          , Uu          , Uu          , Uu^Vu       , Xu          , Xu          , Ms          , Ms          , Gg          , Ha          , Ha          , Ha          , Gg          , Gg          , Gg          , Gg          , Gg          , Gg          , Gg          , Rd          , Gg          , Gg          , Gg          , Gg          , Gg          , Gg          , Ggf^Efm     , Gg          , Gg          , Aa          , Aa          , Aa          , Ha          , Ha          , Ms          , Ms^Vhha     , Ms          , Ms          , Ms          , Ms^Vhha     , Ms          , Ms          
Uu          , Uu          , Ce          , 1 Ke        , Ce          , Uu          , Uu          , Uu          , Xu          , Ms          , Ms          , Ms          , Gg          , Ha          , Gg          , Gg          , Aa          , Aa^Voa      , Gg          , Gg          , Gg          , Gg          , Gg          , Rd          , Gg          , Gg          , Aa          , Gg          , Gg          , Gg          , Gg          , Gg^Vc       , Gg          , Gg          , Gg          , Gg          , Gg          , Ha          , Ha          , Ms          , Ms          , Ms          , Ms          , Ms          , Ms          , Ms          
Uu          , Uu          , Uu          , Ce          , Uu          , Uu          , Uu          , Uu          , Xu          , Gg          , Ms          , Gg          , Ha          , Ha          , Gg          , Aa          , Aa          , Gg          , Aa          , Gg          , Gg          , Gg          , Rd          , Rd          , Gg          , Gg          , Gg          , Aa          , Gg          , Gg          , Ggf^Efm     , Gg          , Gg          , Aa          , Aa          , Aa          , Aa          , Aa          , Ha          , Ms          , Ms          , Cea         , 2 Kea       , Ms          , Ms          , Ms          
Uu          , Uu          , Uu          , Uu          , Uu^Vu       , Uu          , Uu          , Uu          , Rd          , Gg          , Ms          , Ha          , Gg          , Gg          , Gg          , Gg          , Gg          , Gg          , Gg          , Aa          , Gg          , Rd          , Gg          , Gg          , Gg^Vc       , Gg          , Gg          , Aa          , Gg          , Gg          , Gg          , Gg          , Gg          , Gg          , Gg          , Gg          , Gg          , Aa          , Ha          , Ha^Fda      , Ms          , Cea         , Cea         , Cea         , Ms          , Ms          
Xu          , Uu^Vu       , Xu          , Uu          , Xu          , Xu          , Xu          , Rd          , Rd          , Gg          , Gg          , Gg          , Gg          , Gg^Vc       , Gg          , Gg          , Gg          , Aa          , Gg          , Gg          , Gg          , Rd          , Gg          , Gg          , Gg          , Gg          , Gg          , Gg          , Gg          , Gg          , Gg          , Gg          , Aa          , Aa          , Gg          , Gg          , Aa          , Gg          , Ha          , Ha^Fda      , Ms          , Ms          , Ha          , Ms          , Ms          , Ms          
Xu          , Xu          , Ms          , Xu          , Ms          , Xu          , Ms          , Gg          , Gg          , Rd          , Rd          , Gg          , Gg          , Ggf^Efm     , Gg          , Ggf^Efm     , Gg          , Gg          , Rd          , Rd          , Rd          , Rd          , Gg          , Gg          , Ggf^Efm     , Gg          , Gg          , Gg          , Gg          , Gg          , Gg          , Aa^Voa      , Aa          , Gg          , Gg          , Aa          , Gg          , Ha          , Ms          , Ms          , Ms^Vhha     , Ms          , Ha          , Ms          , Ms^Vhha     , Ms          
Ms          , Ms          , Ms          , Ms          , Ms          , Ms          , Ha          , Gg          , Gg          , Gg          , Rd          , Gg          , Gg          , Gg          , Gg          , Gg          , Rd          , Rd          , Gg          , Gg          , Gg          , Gg          , Gg          , Gg^Vo       , Gg          , Gg          , Ggf^Efm     , Gg          , Ggf^Efm     , Gg          , Gg          , Gg          , Gg          , Gg          , Aa          , Aa          , Ha^Fda      , Ms          , Ms          , Ms          , Ms          , Ha          , Ha          , Ms          , Ms          , Ms          
Ms          , Ms          , Ms          , Ms          , Gg          , Gg          , Ha          , Gg          , Gg          , Ggf^Efm     , Gg          , Rd          , Rd          , Gg          , Aa          , Gg          , Rd          , Aa          , Aa          , Gg          , Gg          , Gg          , Gg          , Gg          , Gg          , Gg          , Gg          , Gg          , Gg          , Gg          , Gg          , Gg          , Gg          , Gg          , Aa          , Gg          , Ha^Fda      , Ms          , Ms          , Ms          , Ha          , Ha          , Ha          , Ha^Fda      , Ha^Fda      , Ms          
Ms          , Ms          , Ha          , Ha          , Ha          , Aa          , Gg          , Gg          , Gg          , Gg          , Gg          , Gg          , Aa          , Aa          , Gg          , Rd          , Gg          , Aa          , Gg          , Aa          , Gg          , Gg          , Gg          , Gg          , Gg          , Gg          , Gg^Vo       , Gg          , Gg          , Gg          , Gg          , Gg          , Gg          , Gg          , Aa          , Gg          , Ha          , Ha          , Ha          , Ha          , Ha          , Ha          , Ha          , Ha^Fda      , Ha^Fda      , Ha^Fda      
Ha          , Ha          , Ha          , Ha          , Aa          , Aa          , Gg          , Gg^Vo       , Gg          , Ggf^Efm     , Gg          , Gg          , Aa          , Aa          , Rd          , Rd          , Gg          , Gg          , Gg^Vc       , Gg          , Gg          , Gg          , Gg          , Gg          , Gg          , Gg          , Gg          , Gg          , Gg          , Gg          , Ggf^Efm     , Gg          , Gg          , Gg          , Gg          , Gg          , Ss          , Ai          , Ai          , Ss          , Ai          , Ww          , Ai          , Aa          , Ai          , Ww          
Ha          , Ha          , Gg          , Gg          , Aa          , Gg          , Gg          , Gg          , Gg          , Gg          , Gg          , Aa          , Aa          , Aa^Voa      , Gg          , Rd          , Rd          , Gg          , Gg          , Gg          , Gg          , Gg          , Gg          , Gg          , Aa          , Aa          , Aa          , Gg          , Gg          , Ggf^Efm     , Ggf^Efm     , Gg          , Gg          , Gg          , Ss^Vhs      , Ss          , Ww          , Ai          , Ww          , Ai          , Aa          , Ww          , Aa          , Ww          , Ha          , Ha          
Gg          , Gg          , Gg          , Aa          , Gg          , Aa          , Gg          , Gg          , Gg          , Gg          , Gg          , Aa          , Gg          , Gg          , Gg          , Gg          , Gg          , Rd          , Rd          , Gg          , Aa          , Aa^Voa      , Gg          , Gg          , Coa         , Coa         , Coa         , Gg          , Gg          , Gg          , Gg          , Gg          , Ss          , Ss          , Ww          , Ai          , Ha          , Ha          , Ha          , Ha          , Ms          , Ha          , Ha          , Aa          , Ms          , Ms          
Gg          , Gg          , Gg          , Gg          , Gg          , Gg          , Ggf^Efm     , Gg          , Gg          , Gg          , Aa          , Gg          , Gg          , Gg          , Gg          , Gg          , Gg          , Gg          , Gg          , Rd          , Rd          , Aa          , Aa          , Gg          , Coa         , 4 Koa       , Coa         , Gg          , Gg          , Gg          , Ss          , Gg          , Ss          , Ww          , Ss          , Ss          , Ms          , Ms          , Ms          , Ms          , Ms^Vhha     , Ms          , Ha          , Ms          , Ms^Vhha     , Ms          
Gg          , Gg          , Gg          , Gg          , Gg          , Gg          , Gg          , Gg          , Aa          , Gg          , Gg          , Gg          , Gg          , Gg          , Gg          , Gg          , Gg          , Gg          , Gg          , Gg          , Gg          , Aa          , Rd          , Gg          , Gg          , Coa         , Gg          , Gg          , Gg          , Ss          , Ww          , Ss          , Ww          , Ww          , Ss          , Gg          , Aa          , Ha          , Ha          , Ms          , Ha          , Ms          , Cea         , 3 Kea       , Ms          , Ms          
Gg          , Gg          , Gg          , Gg          , Gg          , Gg          , Gg          , Aa          , Gg          , Gg          , Aa          , Gg          , Aa          , Gg          , Aa          , Gg          , Aa          , Gg          , Gg          , Aa          , Aa          , Gg          , Gg          , Rd          , Rd          , Gg          , Gg          , Gg          , Ss          , Ss          , Ww          , Ss          , Ss^Vhs      , Ss          , Gg          , Aa          , Gg          , Ha          , Ms          , Ha          , Ha          , Ms          , Cea         , Cea         , Ms          , Ms          
Gg          , Gg          , Ggf^Efm     , Ggf^Efm     , Gg          , Gg          , Aa          , Gg          , Gg          , Gg          , Gg          , Aa          , Aa          , Aa          , Gg          , Aa          , Aa          , Gg          , Gg          , Gg          , Gg          , Gg          , Gg          , Gg          , Ss          , Rd          , Rd          , Ss          , Ss          , Ww          , Ss          , Ss          , Gg          , Gg          , Gg          , Aa          , Ha          , Ha          , Ms          , Ms          , Ms          , Ha          , Ms          , Ms          , Ms          , Ms          
Gg          , Gg          , Gg          , Gg          , Gg          , Gg          , Gg          , Gg          , Ggf^Efm     , Gg          , Gg          , Gg          , Gg          , Aa          , Gg          , Aa          , Aa          , Gg          , Gg          , Gg          , Gg          , Gg          , Ss          , Ss          , Ww          , Ss          , Ww          , Wwf         , Wwf         , Ww          , Ss          , Gg          , Aa          , Gg          , Aa          , Aa          , Ha          , Ha          , Ms          , Ms^Vhha     , Ms          , Ms          , Ms          , Ms          , Ai          , Ai          
Gg          , Gg          , Gg          , Gg          , Gg          , Gg          , Gg          , Gg          , Ggf^Efm     , Gg          , Gg          , Gg          , Gg          , Gg          , Gg          , Aa          , Gg          , Gg          , Gg          , Gg          , Gg          , Ss          , Ww          , Ww          , Ss          , Ww          , Ss^Vhs      , Ss          , Rd          , Ss          , Gg          , Gg          , Gg          , Aa          , Aa          , Gg          , Ha          , Ha          , Ms          , Ms          , Ms          , Ms          , Ai          , Ai          , Ms^Vhha     , Ms          
Gg          , Gg          , Aa          , Gg          , Gg          , Gg          , Gg          , Gg          , Gg          , Gg          , Gg          , Gg^Vc       , Gg          , Gg          , Gg          , Gg          , Gg          , Gg          , Ss          , Rd          , Ss          , Ss          , Ww          , Gg          , Ss          , Ss          , Gg          , Gg          , Gg          , Rd          , Gg          , Gg          , Aa          , Gg          , Gg          , Gg          , Gg          , Ha          , Ms          , Ms          , Ms          , Ms          , Ai          , Ai          , Ms          , Ms          
Gg          , Gg          , Gg          , Aa          , Aa          , Gg          , Gg          , Gg          , Gg          , Gg          , Gg          , Gg          , Gg          , Gg          , Gg          , Gg          , Ss^Vm       , Ss          , Ww          , Ww          , Ww          , Ww          , Gg          , Gg          , Gg          , Gg          , Gg          , Gg          , Gg          , Rd          , Rd          , Gg          , Gg          , Gg          , Gg          , Aa          , Ha          , Ha          , Ha          , Ms          , Ms          , Ms          , Ms          , Ai          , Ai          , Ms          
Gg          , Gg          , Gg          , Aa          , Aa          , Aa          , Gg          , Gg^Vo       , Gg          , Gg          , Gg          , Gg          , Gg          , Gg          , Ss          , Ss          , Ww          , Ww          , Rd          , Ss          , Gg          , Gg          , Aa          , Gg          , Aa          , Aa          , Gg          , Ggf^Efm     , Gg          , Gg          , Gg          , Rd          , Rd          , Gg          , Ggf^Efm     , Gg          , Gg          , Ha          , Ha          , Ha          , Ha          , Ms          , Ms          , Ms          , Ai          , Ms          
Gg          , Gg          , Gg          , Gg          , Gg          , Gg          , Gg          , Gg          , Gg          , Gg          , Gg          , Gg          , Ss          , Rd          , Wwf         , Ww          , Ss          , Ss          , Gg          , Gg          , Gg          , Gg          , Aa          , Aa          , Gg          , Gg          , Gg          , Gg          , Gg          , Ggf^Efm     , Gg          , Gg          , Rd          , Gg          , Ggf^Efm     , Gg          , Aa          , Aa          , Ha          , Ha          , Ms          , Ms^Vhha     , Ms          , Ai          , Ms          , Ms          
Gg          , Gg          , Gg          , Gg          , Gg          , Gg          , Gg          , Gg          , Gg          , Gg          , Ss          , Rd          , Wwf         , Ww          , Rd          , Ss          , Gg          , Gg          , Gg          , Gg          , Gg          , Gg          , Gg          , Gg          , Gg          , Gg          , Aa^Voa      , Gg          , Gg          , Gg          , Gg          , Gg          , Rd          , Gg^Vo       , Gg          , Gg          , Aa          , Gg          , Ha          , Ha          , Ms          , Ms          , Ai          , Ai          , Ms          , Ms          
Gg          , Gg          , Gg          , Gg          , Gg          , Gg          , Ss          , Gg          , Ss          , Ss          , Ss          , Ss          , Ww          , Ss          , Coa         , Coa         , Coa         , Gg          , Aa          , Gg          , Gg          , Gg          , Gg          , Gg          , Gg          , Gg          , Gg          , Gg          , Aa          , Aa          , Gg          , Gg          , Gg          , Rd          , Rd          , Gg          , Gg          , Aa          , Ha          , Ms          , Ai          , Ai          , Ms          , Ms          , Ms^Vhha     , Ms          
Gg          , Gg          , Gg          , Gg          , Ss          , Gg          , Ss          , Ss          , Rd          , Ss          , Ss          , Ww          , Ss          , Ss          , Coa         , 5 Koa       , Coa         , Gg          , Gg          , Gg          , Gg          , Gg^Vc       , Gg          , Gg          , Gg          , Gg          , Gg          , Gg          , Aa          , Aa          , Gg          , Gg          , Gg          , Gg          , Gg          , Rd          , Rd          , Aa          , Gg          , Ai          , Ha          , Ww          , Uu          , Uu          , Uu          , Xu          
Gg          , Gg          , Gg          , Ss          , Gg          , Ss          , Ww          , Ww          , Ww          , Ss          , Ww          , Ww          , Ss          , Ss          , Gg          , Coa         , Gg          , Gg          , Aa          , Aa          , Gg          , Gg          , Gg          , Gg          , Gg          , Gg          , Gg          , Gg          , Gg          , Gg          , Gg          , Gg          , Gg          , Ggf^Efm     , Gg          , Gg          , Rd          , Gg          , Gg          , Rd          , Ww          , Ww          , Cud         , Uu          , Xu          , Xu          
Gg          , Gg          , Gg          , Ss          , Ww          , Ww          , Ss          , Ss          , Ss          , Ww          , Ss          , Rd          , Gg          , Gg          , Gg          , Gg          , Gg          , Gg          , Aa^Vca      , Aa          , Gg          , Gg          , Gg          , Gg          , Gg          , Gg          , Aa          , Aa          , Aa          , Gg          , Ww          , Ww          , Gg          , Ggf^Efm     , Gg          , Gg          , Gg          , Rd          , Rd          , Rd          , Ww          , Cud         , Uu          , Uu          , Xu          , Xu          
Gg          , Gg          , Ss          , Ss          , Ai          , Ss          , Gg          , Gg          , Gg^Vc       , Ss          , Gg          , Gg          , Gg          , Gg^Vo       , Gg          , Gg          , Aa          , Gg          , Aa          , Gg          , Aa          , Gg          , Ha          , Gg          , Aa          , Aa          , Aa          , Aa          , Gg          , Ww          , Xu          , Ww          , Ww          , Gg          , Gg          , Gg          , Ww          , Ww          , Ww          , Rd          , Ww          , Ww          , Ww          , Uu          , Uu          , Xu          
Gg          , Gg          , Ai          , Ww          , Ai          , Ss          , Gg          , Gg          , Ss          , Ss          , Gg          , Gg          , Gg          , Gg          , Gg          , Gg          , Aa          , Aa          , Ha          , Aa          , Aa          , Gg          , Ha          , Ha          , Ha          , Ha          , Ha          , Ha          , Ha          , Ha          , Xu          , Cud         , Uu          , Ww          , Ww          , Ww          , Ww          , Ww          , Ww          , Ww^Bsb|     , Uu          , Ww          , Uu          , Cud         , Xu          , Xu          
Ss          , Ss          , Ww          , Ai          , Ai          , Ai          , Gg          , Gg          , Gg          , Gg          , Aa          , Gg          , Aa          , Gg          , Aa          , Aa          , Gg          , Gg          , Ha          , Aa          , Ha          , Ha          , Ha          , Ha          , Ha^Fma      , Ha          , Ha^Fda      , Ha          , Ha^Fma      , Ha^Fda      , Xu          , Uu          , Uu          , Uu          , Uu          , Ww          , Cud         , Uu          , Uu          , Ur          , Ur          , Uu          , Uu          , Cud         , Cud         , Xu          
Ww          , Ai          , Ai          , Ai          , Aa          , Aa          , Aa          , Gg          , Aa          , Aa          , Aa          , Aa          , Gg          , Gg          , Ha          , Ha          , Ha          , Ha          , Ha          , Ha          , Ha          , Ha          , Ha          , Ha          , Ha          , Ha^Fma      , Ha          , Ha          , Ha          , Ha          , Ms          , Xu          , Xu          , Xu          , Uu          , Uu          , 6 Kud       , Uu          , Uu          , Ur          , Ur          , Ur          , Ur          , Uu          , Uu          , Xu          
Ai          , Ss          , Ha          , Gg          , Ha          , Aa          , Ha          , Aa          , Ha          , Gg          , Ha          , Ha          , Ha          , Ha          , Ha          , Ha          , Ha^Fda      , Ha          , Ha^Fda      , Ha^Fda      , Ms          , Ha          , Ha^Fma      , Ha          , Ms          , Ms          , Ms          , Ha          , Ms          , Ms          , Ms          , Ms          , Ms          , Xu          , Xu          , Xu          , Xu          , Uu          , Uu          , Uu^Vud      , Uu          , Ur          , Ur          , Ur          , Ur          , Uu          
Mm          , Ha          , Ha          , Ha          , Ha          , Ha^Fda      , Ha^Fda      , Ha^Fda      , Ms          , Ha          , Ms          , Ms          , Ms          , Ms          , Ms          , Ms          , Ms          , Ha^Fda      , Ms          , Ms          , Ms          , Ms          , Ms          , Ms          , Ms          , Ms          , Ms          , Ms          , Ms          , Ms          , Ms          , Ms          , Ms          , Ms          , Xu          , Xu          , Xu          , Xu          , Uu          , Uu          , Uu          , Uu          , Uu          , Ur          , Ur          , Ur          
Ms          , Ms          , Ms          , Ms          , Ms          , Ms          , Ms          , Ms          , Ms          , Ms          , Ms          , Ms          , Ms          , Ms          , Ms          , Ms          , Ms          , Ms          , Ms          , Ms          , Ms          , Ms          , Ms          , Ms          , Ms          , Ms          , Ms          , Ms          , Ms          , Ms          , Ms          , Ms          , Ms          , Ms          , Xu          , Xu          , Xu          , Xu          , Xu          , Xu          , Xu          , Uu          , Uu          , Uu          , Uu          , Ur          
