border_size=1
usage=map

Xu          , Xu          , Xu          , Xu          , Xu          , Xu          , Xu          , Xu          , Xu          , Qxu         , Qxu         , Qxu         , Uu          , Uu          , Uu          , Uu          , Uu          , Uu          , Xu          , Xu          , Xu          , Xu          , Xu          , Xu          , Uu          , Ur          , Uu          , Uu          , Xu          , Ur          , Ur          , Xu          , Xu          , Xu          , Xu          , Ur          , Uu          , Cud         , Xu          , Xu          
Xu          , Xu          , Xu          , Xu          , Xu          , Xu          , Xu          , Xu          , Xu          , Xu          , Qxu         , Qxu         , Qxu^Bs/     , Uu          , Uu          , Uu          , Qxu         , Xu          , Xu          , Xu          , Xu          , Xu          , Xu          , Uu          , Uu          , Uu          , Uu          , Uu          , Xu          , Xu          , Xu          , Ur          , Xu          , Xu          , Xu          , Uu          , Uu          , Cud         , Xu          , Xu          
Xu          , Xu          , Xu          , Xu          , Xu          , Xu          , Xu          , Xu          , Xu          , Xu          , Uu          , Qxu^Bs/     , Qxu^Bs/     , Uu          , Qxu^Bs|     , Qxu         , Qxu         , Qxu         , Qxu         , Xu          , Xu          , Xu          , Uu^Vu       , Uu          , Ur          , Ur          , Uu^Vu       , Xu          , Xu          , Xu          , Xu          , Uu^Vu       , Ur          , Xu          , Xu          , Ur          , Uu          , Xu          , Xu          , Xu          
Xu          , Xu          , Xu          , Xu          , Xu          , Xu          , Xu          , Xu          , Xu          , Xu          , Cud         , Uu          , Uu          , Qxu         , Cud         , Qxu         , Qxu         , Qxu         , Qxu         , Cud         , Xu          , Cud         , Uu          , Uu          , Uu          , Uu          , Xu          , Xu          , Xu          , Xu          , Xu          , Xu          , Xu          , Ur          , Uu          , Ur          , Xu          , Xu          , Xu          , Xu          
Xu          , Xu          , Xu          , Xu          , Xu          , Xu          , Xu          , Xu          , Xu          , Uu          , Ur          , Uu          , Cud         , Xu          , Uu          , Xu          , Qxu         , Qxu         , Qxu         , Qxu         , Qxu^Bs/     , Qxu^Bs/     , Qxu         , Uu          , Cud         , Uu          , Xu          , Xu          , Xu          , Xu          , Xu          , Xu          , Xu          , Uu          , Ur          , Uu          , Xu          , Xu          , Xu          , Xu          
Xu          , Xu          , Xu          , Xu          , Xu          , Xu          , Xu          , Xu          , Xu          , Uu          , Ur          , Uu          , Xu          , Xu          , Xu          , Cud         , Xu          , Qxu         , Qxu         , Cud         , Cud         , Qxu         , Qxu^Bs/     , Qxu^Bs/     , Xu          , Xu          , Xu          , Xu          , Xu          , Xu          , Xu          , Xu          , Xu          , Xu          , Ur          , Xu          , Xu          , Xu          , Xu          , Xu          
Xu          , Xu          , Xu          , Xu          , Xu          , Xu          , Xu          , Xu          , Xu          , Uu          , Uu^Uf       , Uu^Vu       , Uu^Uf       , Xu          , Xu          , Uu          , Cud^Sco     , Qxu         , Qxu         , Qxu         , Qxu         , Cud         , Qxu         , Qxu         , Qxu         , Cud         , Uu          , Xu          , Xu          , Xu          , Xu          , Xu          , Ur          , Ur          , Xu          , Xu          , Xu          , Xu          , Xu          , Xu          
Xu          , Xu          , Xu          , Xu          , Xu          , Xu          , Xu          , Xu          , Xu          , Uu^Uf       , Uu          , Ur          , Ur          , Uu^Uf       , Uu^Vu       , Uu          , Uu          , Uu^Vu       , Uu          , Qxu         , Xu          , Qxu         , Xu          , Xu          , Qxu^Bs/     , Uu          , Qxu         , Uu          , Uu          , Xu          , Uu          , Cud         , Xu          , Xu          , Xu          , Xu          , Xu          , Xu          , Xu          , Xu          
Xu          , Xu          , Xu          , Xu          , Xu          , Xu          , Xu          , Xu          , Uu^Vu       , Uu^Uf       , Uu^Uf       , Uu^Uf       , Uu          , Uu          , Ur          , Ur          , Uu          , Ur          , Uu          , Cud^Sco     , Xu          , Cud         , Uu          , Cud         , Qxu         , Qxu         , Qxu         , Qxu         , Qxu^Bs/     , Uu          , Uu^Vu       , Xu          , Xu          , Xu          , Xu          , Xu          , Xu          , Xu          , Xu          , Xu          
Xu          , Xu          , Xu          , Xu          , Xu          , Xu          , Xu          , Xu          , Uu          , Uu^Uf       , Uu          , Uu^Uf       , Uu          , Uu          , Ur          , Uu          , Uu          , Uu          , Uu          , Uu^Vu       , Uu          , Uu          , Xu          , Xu          , Uu^Vu       , Qxu         , Qxu^Bs/     , Qxu^Bs/     , Qxu^Bs/     , Qxu^Bs/     , Xu          , Xu          , Xu          , Xu          , Xu          , Xu          , Xu          , Xu          , Qxu         , Qxu         
Xu          , Xu          , Xu          , Xu          , Xu          , Xu          , Xu          , Xu          , Uu^Uf       , Uu          , Uu^Uf       , Uu^Uf       , Uu          , Ur          , Uu          , Uu          , Qxu         , Qxu         , Xu          , Uu          , Uu          , Uu          , Uu          , Xu          , Uu          , Uu          , Qxu^Bs/     , Qxu^Bs/     , Qxu         , Qxu         , Qxu         , Qxu         , Qxu         , Qxu         , Qxu         , Qxu         , Qxu         , Qxu         , Qxu         , Qxu         
Xu          , Xu          , Xu          , Xu          , Xu          , Xu          , Xu          , Xu          , Uu          , Uu^Uf       , Uu          , Uu          , Uu          , Ur          , Cud         , Xu          , Qxu         , Qxu         , Qxu         , Xu          , Uu          , Ur          , Cud         , Cud         , Ur          , Uu          , Qxu         , Qxu         , Qxu         , Qxu         , Qxu         , Qxu         , Qxu         , Qxu         , Qxu         , Qxu         , Qxu         , Qxu         , Qxu         , Qxu         
Xu          , Xu          , Xu          , Xu          , Xu          , Xu          , Xu          , Xu          , Xu          , Uu^Vu       , Xu          , Xu          , Xu          , Cud         , Cud         , Cud         , Uu          , Xu          , Qxu^Bs/     , Qxu^Bs/     , Qxu         , Qxu         , Qxu         , Uu          , Qxu^Bs\     , Qxu^Bs\     , Cud         , Qxu         , Xu          , Qxu         , Xu          , Qxu         , Xu          , Qxu         , Qxu         , Qxu         , Xu          , Qxu         , Xu          , Qxu         
Xu          , Xu          , Xu          , Xu          , Xu          , Xu          , Xu          , Xu          , Xu          , Xu          , Uu^Vu       , Xu          , Xu          , Cud         , 1 Kud       , Cud         , Xu          , Ur          , Qxu         , Qxu         , Qxu         , Qxu         , Qxu         , Qxu         , Xu          , Ur          , Uu          , Cud         , Dd          , Xu          , Xu          , Xu          , Md          , Xu          , Xu          , Xu          , Xu          , Xu          , Md          , Xu          
Xu          , Xu          , Xu          , Xu          , Xu          , Xu          , Xu          , Xu          , Xu          , Xu          , Uu          , Ur          , Uu          , Uu          , Ur          , Uu          , Xu          , Xu          , Xu          , Xu          , Xu          , Xu          , Xu          , Xu          , Dd          , Cud         , Cud         , Cud         , Dd          , Hd          , Md          , Md          , Md          , Md          , Md          , Xu          , Md          , Md          , Md          , Md          
Xu          , Xu          , Xu          , Xu          , Xu          , Xu          , Xu          , Xu          , Ur          , Ur          , Xu          , Xu          , Xu          , Uu          , Ur          , Uu          , Cud         , Xu          , Xu          , Xu          , Xu          , Xu          , Md          , Hd          , Hd          , Dd          , Dd          , Dd          , Rd          , Hd          , Hd          , Md          , Md          , Md          , Md          , Md          , Md          , Md          , Md          , Md          
Xu          , Xu          , Xu          , Xu          , Xu          , Uu^Vu       , Ur          , Ur          , Xu          , Xu          , Xu          , Xu          , Xu          , Cud         , Ur          , Ur          , Ur          , Cud         , Cud         , Xu          , Xu          , Xu          , Md          , Md          , Md          , Hd          , Hd          , Md          , Hd          , Rd          , Hd          , Md          , Md          , Md          , Md          , Md          , Md          , Md          , Md          , Md          
Xu          , Xu          , Xu          , Xu          , Cud         , Ur          , Xu          , Xu          , Xu          , Xu          , Xu          , Xu          , Xu          , Cud         , Cud         , Ur          , Ur          , Ur          , Cud         , Cud         , Ds          , Dd^Vda      , Hd          , Md          , Md          , Hd          , Hd          , Hd          , Hd          , Rd          , Hd          , Dd^Vda      , Hd          , Hd          , Hd          , Md          , Hd          , Hd          , Hd          , Md          
Xu          , Xu          , Xu          , Cud         , Rd          , Cud         , Xu          , Xu          , Xu          , Xu          , Md          , Md          , Hd          , Ds          , Ds          , Cud         , Cud         , Cud         , Rd          , Dd          , Dd          , Dd          , Dd          , Hd          , Hd          , Hd          , Dd          , Hd          , Hd          , Rd          , Hd          , Hd          , Hd          , Dd          , Hd          , Hd          , Hd          , Hd          , Hd          , Hd          
Hd          , Dd          , Ds          , Ds          , Rd          , Ds          , Ds          , Dd          , Md          , Md          , Md          , Md          , Hd          , Dd          , Dd          , Dd          , Ds          , Ds          , Rd          , Dd          , Dd          , Dd          , Dd          , Hd          , Hd          , Hd          , Dd          , Hd          , Hd          , Hd          , Rd          , Hd          , Ds          , Dd          , Dd          , Hd          , Hd          , Hd          , Dd          , Hd          
Md          , Hd          , Hd          , Ds          , Rd          , Ds          , Hd          , Md          , Md          , Md          , Md          , Hd          , Hd          , Dd          , Dd          , Dd          , Dd          , Ds          , Rd          , Ds          , Ds          , Dd          , Dd          , Hd          , Hd          , Hd          , Dd          , Dd^Do       , Dd          , Dd          , Dd^Vdt      , Rd          , Dd          , Dd          , Dd          , Ds          , Dd          , Ds          , Dd          , Dd          
Md          , Md          , Hd          , Dd          , Rd          , Dd          , Dd^Vda      , Md          , Md          , Md          , Md          , Hd          , Dd^Vda      , Hd          , Hd          , Dd          , Hd          , Dd          , Dd          , Rd          , Dd          , Dd          , Dd          , Dd          , Dd          , Dd          , Dd          , Dd          , Ds          , Dd          , Dd          , Dd          , Rd          , Dd          , Dd          , Dd          , Ds          , Dd          , Dd          , Ds          
Md          , Md          , Hd          , Dd          , Rd          , Dd          , Hd          , Hd          , Md          , Md          , Md          , Md          , Hd          , Hd          , Hd          , Hd          , Hd          , Dd          , Dd          , Rd          , Rd          , Ds          , Dd          , Dd          , Dd          , Dd          , Dd          , Dd          , Dd          , Dd          , Ds          , Dd          , Dd          , Rd          , Dd          , Dd          , Dd          , Ds          , Dd          , Dd          
Hd          , Hd          , Hd          , Dd          , Dd          , Dd          , Dd          , Hd          , Hd          , Hd          , Hd          , Hd          , Hd          , Hd          , Hd          , Hd          , Dd          , Dd          , Dd          , Dd          , Dd          , Rd          , Rd          , Dd          , Ds          , Dd          , Dd          , Dd          , Dd          , Dd          , Ds          , Dd          , Ce          , Ce          , Ce          , Dd          , Dd          , Dd          , Dd          , Dd          
Hd          , Md          , Hd          , Dd          , Dd          , Rd          , Rd          , Dd          , Hd          , Hd          , Hd          , Hd          , Hd          , Hd          , Hd          , Hd          , Dd          , Dd          , Dd          , Dd          , Dd          , Dd          , Rd          , Dd^Do       , Dd          , Dd          , Dd          , Dd          , Dd          , Dd          , Ds          , Dd          , Ce          , 3 Ke        , Ce          , Dd          , Dd          , Ds          , Hd          , Hd          
Md          , Hd          , Hd          , Hd          , Hd          , Dd          , Dd          , Dd          , Hd          , Hd          , Hd          , Hd          , Hd          , Hd          , Dd          , Dd          , Ds          , Dd          , Dd          , Dd          , Ds          , Ds          , Rd          , Ds          , Dd          , Dd          , Ds          , Dd          , Ds          , Ds          , Dd          , Dd          , Dd          , Ce          , Dd          , Dd          , Dd          , Dd          , Hd          , Hd          
Hd          , Hd          , Hd          , Hd          , Hd          , Hd          , Dd          , Dd          , Dd          , Hd          , Dd          , Dd          , Ds          , Dd          , Ds          , Dd          , Dd          , Dd          , Dd          , Dd          , Dd          , Dd          , Dd          , Rd          , Dd          , Dd          , Dd          , Dd          , Dd          , Dd^Vdt      , Dd          , Dd          , Rd          , Dd          , Dd          , Dd          , Dd          , Dd^Vdt      , Hd          , Hd          
Hd          , Hd          , Hd          , Hd          , Hd          , Dd          , Ds          , Rd          , Rd          , Ds          , Dd          , Dd          , Dd          , Dd          , Dd          , Dd          , Dd          , Dd          , Dd^Vdt      , Dd          , Dd          , Dd          , Dd          , Dd          , Dd          , Rd          , Dd          , Dd          , Dd          , Dd          , Dd          , Rd          , Dd          , Dd          , Dd          , Dd          , Hd          , Hd          , Hd          , Hd          
Md          , Hd          , Hd          , Hd          , Hd          , Dd          , Dd          , Dd          , Dd          , Dd          , Dd          , Dd          , Dd          , Dd          , Dd          , Dd          , Dd          , Dd          , Dd          , Dd          , Dd          , Dd          , Dd          , Dd          , Dd          , Rd          , Dd          , Dd          , Dd          , Dd          , Rd          , Dd          , Dd          , Dd^Vdt      , Dd          , Dd          , Hd          , Hd          , Hd          , Hd          
Md          , Hd          , Hd          , Hd          , Dd          , Dd          , Dd          , Dd          , Dd          , Rd          , Rd          , Hd          , Rd          , Dd          , Dd          , Dd          , Dd          , Dd          , Dd          , Ds          , Dd          , Dd          , Dd          , Ds          , Dd          , Rd          , Dd          , Dd          , Dd          , Rd          , Dd          , Dd          , Dd          , Dd          , Dd          , Hd          , Hd          , Hd          , Hd          , Hd          
Md          , Hd          , Hd          , Hd          , Hd          , Dd          , Ds          , Ds          , Dd          , Dd          , Hd          , Rd          , Hd          , Dd          , Rd          , Dd          , Ce          , Ce          , Ce          , Ds          , Dd          , Dd          , Dd          , Dd          , Dd          , Rd          , Dd          , Dd          , Dd          , Rd          , Ds          , Dd          , Dd          , Dd          , Dd          , Hd          , Hd          , Hd          , Hd          , Hd          
Md          , Md          , Hd          , Hd          , Hd          , Dd          , Dd          , Dd          , Dd          , Dd          , Dd          , Hd          , Dd          , Dd          , Dd          , Rd          , Ce          , 2 Ke        , Ce          , Dd          , Dd          , Dd          , Dd          , Dd          , Dd          , Rd          , Dd          , Ds          , Rd          , Rd          , Dd          , Dd          , Dd          , Dd          , Dd          , Hd          , Hd          , Hd          , Hd          , Hd          
Md          , Md          , Hd          , Hd          , Hd          , Hd          , Dd          , Dd          , Dd          , Dd          , Dd          , Dd          , Dd          , Ds          , Dd          , Dd          , Dd          , Ce          , Dd          , Rd          , Rd          , Dd          , Dd          , Dd^Vdt      , Dd          , Rd          , Rd          , Rd          , Dd          , Dd          , Dd          , Dd          , Dd          , Dd          , Dd          , Dd          , Dd          , Dd          , Dd          , Hd          
Md          , Md          , Md          , Hd          , Hd          , Hd          , Hd          , Ds          , Hd          , Dd          , Dd          , Dd^Vdt      , Dd          , Dd          , Dd          , Dd          , Dd          , Dd          , Dd          , Dd          , Dd          , Rd          , Rd          , Dd          , Ds          , Rd          , Dd          , Rd          , Dd          , Rd          , Rd          , Dd          , Dd          , Dd^Vdt      , Dd          , Dd          , Dd          , Ds          , Dd          , Dd          
Md          , Md          , Md          , Hd          , Hd          , Hd          , Hd          , Hd          , Hd          , Hd          , Hd          , Dd          , Dd          , Dd          , Dd          , Dd          , Dd          , Dd          , Dd^Vdt      , Dd          , Dd          , Dd          , Dd          , Dd          , Rd          , Rd          , Ce          , Ce          , Ce          , Dd          , Dd          , Dd          , Dd          , Dd          , Dd          , Dd          , Dd          , Dd          , Dd          , Dd          
Md          , Md          , Md          , Hd          , Hd          , Hd          , Hd          , Hd          , Hd          , Hd          , Hd          , Hd          , Dd          , Dd          , Dd          , Dd          , Dd          , Dd          , Dd          , Dd          , Dd          , Dd          , Dd          , Rd          , Dd          , Dd          , Ce          , 4 Ke        , Ce          , Dd          , Rd          , Rd          , Dd          , Dd          , Dd          , Dd          , Dd          , Dd          , Dd          , Dd          
Md          , Md          , Dd          , Hd          , Hd          , Hd          , Hd          , Hd          , Hd          , Hd          , Hd          , Hd          , Hd          , Dd          , Dd          , Dd          , Dd          , Dd          , Dd          , Dd          , Dd          , Dd          , Dd          , Rd          , Rd          , Dd          , Dd          , Ce          , Dd          , Dd          , Rd          , Dd          , Ce          , Ce          , Ce          , Dd          , Dd          , Dd          , Dd          , Dd          
Md          , Md          , Hd          , Hd          , Hd          , Hd          , Hd          , Hd          , Hd          , Hd          , Hd          , Hd          , Hd          , Dd          , Dd          , Dd          , Dd          , Dd          , Dd          , Dd          , Dd          , Dd          , Dd          , Dd          , Rd          , Dd          , Dd          , Dd          , Dd          , Dd          , Rd          , Dd          , Ce          , 6 Ke        , Ce          , Dd          , Dd          , Dd          , Dd          , Dd          
Md          , Hd          , Hd          , Hd          , Hd          , Hd          , Hd          , Hd          , Dd          , Dd          , Dd          , Hd          , Dd          , Dd          , Dd          , Dd          , Dd          , Dd          , Dd          , Dd          , Dd          , Dd          , Dd          , Dd          , Rd          , Dd          , Dd          , Dd          , Dd^Vdt      , Dd          , Rd          , Dd          , Dd          , Ce          , Dd          , Rd          , Rd          , Dd          , Dd          , Dd          
Hd          , Hd          , Hd          , Hd          , Hd          , Hd          , Dd          , Dd          , Dd          , Dd          , Dd          , Dd          , Dd          , Dd          , Ds          , Dd          , Dd          , Dd          , Dd          , Dd          , Dd          , Dd          , Ds          , Dd          , Dd          , Rd          , Dd          , Dd          , Dd          , Dd          , Dd          , Rd          , Rd          , Dd          , Rd          , Dd          , Rd          , Dd          , Dd          , Dd          
Hd          , Hd          , Hd          , Hd          , Hd          , Hd          , Dd          , Dd          , Dd          , Dd          , Dd          , Dd          , Dd          , Dd          , Dd          , Dd          , Dd          , Dd          , Dd          , Dd          , Dd          , Dd          , Dd          , Dd          , Dd          , Ds          , Rd          , Dd          , Dd          , Dd          , Dd          , Dd          , Dd          , Rd          , Dd          , Rd          , Rd          , Dd          , Dd          , Dd          
Hd          , Hd          , Hd          , Dd          , Dd          , Dd          , Ds          , Dd          , Dd          , Dd          , Dd          , Dd          , Dd          , Dd          , Dd          , Dd          , Dd          , Dd          , Dd          , Dd          , Dd          , Dd          , Dd          , Dd          , Dd          , Dd          , Dd          , Dd          , Ce          , Ce          , Ce          , Dd          , Dd          , Dd          , Ds          , Dd          , Dd          , Rd          , Rd          , Dd          
Hd          , Hd          , Hd          , Dd          , Dd          , Dd          , Dd          , Dd          , Dd          , Dd          , Dd          , Dd          , Dd          , Dd          , Dd          , Dd          , Dd          , Dd          , Dd          , Dd          , Dd          , Dd          , Dd          , Dd          , Dd          , Dd          , Dd          , Dd          , Ce          , 5 Ke        , Ce          , Dd          , Dd          , Dd          , Dd          , Ds          , Dd          , Dd          , Dd          , Rd          
Hd          , Hd          , Dd          , Dd          , Dd          , Dd          , Ds          , Dd          , Ds          , Dd          , Dd          , Dd          , Dd          , Dd          , Dd          , Dd          , Dd          , Dd          , Dd          , Dd          , Dd          , Dd          , Dd          , Dd^Vdt      , Dd          , Dd          , Dd          , Dd          , Dd          , Ce          , Dd          , Dd          , Dd          , Dd          , Dd          , Dd          , Dd          , Dd          , Dd          , Rd          
Hd          , Dd          , Dd          , Dd          , Dd          , Dd          , Dd          , Dd          , Dd          , Ds          , Dd          , Dd          , Dd          , Dd          , Dd          , Dd          , Dd          , Dd          , Dd          , Dd          , Dd          , Dd          , Dd          , Dd          , Dd          , Dd          , Dd          , Dd          , Dd          , Dd          , Dd          , Dd          , Dd^Vdt      , Dd          , Dd          , Dd          , Dd          , Dd          , Dd          , Dd          
Hd          , Dd          , Dd          , Dd          , Dd          , Dd          , Dd          , Dd          , Dd          , Dd          , Dd          , Dd          , Dd          , Dd          , Dd          , Dd          , Dd          , Dd          , Dd          , Dd          , Dd          , Dd          , Dd          , Dd          , Dd          , Dd          , Dd          , Dd          , Dd          , Dd          , Dd          , Dd          , Dd          , Dd          , Dd          , Dd          , Dd          , Dd          , Dd          , Dd          
