border_size=1
usage=map

Wo          , Wo          , Wo          , Wo          , Wo          , Wo          , Wo          , Wo          , Wo          , Wo          , Wo          , Wo          , Wo          , Wo          , Wo          , Wo          , Wo          , Wo          , Wo          
Wo          , Wo          , Wo          , Wo          , Ww          , Wo          , Ww          , Ww          , Ww          , Wo          , Ww          , Ww          , Ww          , Wo          , Ww          , Wo          , Wo          , Wo          , Wo          
Wo          , Wo          , Ww          , Ww          , Ww          , Ww          , Ds          , Ww          , Ww          , Ww          , Ww          , Ww          , Ds          , Ww          , Ds          , Ww          , Ww          , Wo          , Wo          
Ww          , Ww          , Ww          , Ds          , Ww          , Ww          , Ds          , Ds          , Ds          , Ww          , Ds          , Ds          , Dd          , Dd          , Dd          , Ww          , Ww          , Wo          , Ww          
Ww          , Ww          , Dd          , Ds          , Dd          , Dd          , Dd          , Dd          , Dd          , Dd          , Dd          , Dd          , Dd          , Dd          , Dd          , Dd          , Ds          , Ww          , Ww          
Ww          , Ww          , Dd          , Dd          , Dd          , Dd          , Dd          , Hd          , Dd          , Dd          , Dd          , Hd          , Dd          , Dd          , Dd          , Dd          , Ds          , Ww          , Ww          
Ww          , Ww          , Ds          , Dd          , Dd          , Dd          , Dd          , Dd          , Dd          , Dd          , Dd          , Dd          , Dd          , Dd          , Dd          , Dd          , Ww          , Ww          , Ww          
Wo          , Ww          , Ww          , Ds          , Dd          , Dd          , Hd          , Dd          , Dd          , Dd          , Dd          , Gs^Ft       , Gs^Ft       , Dd          , Ww          , Ds          , Ww          , Ww          , Wo          
Wo          , Wo          , Ww          , Ww          , Dd          , Dd          , Dd          , Hd          , Md          , Md          , Hd          , Gs^Ft       , Gs^Ft       , Gs^Ft       , Ds          , Ww          , Ww          , Wo          , Wo          
Ww          , Ww          , Dd          , Ds          , Dd          , Dd          , Gs^Ft       , Hd          , Gs^Ft       , Gs^Ft       , Hd          , Gs^Ft       , Gs^Ft       , Gs^Ft       , Gs^Ft       , Ds          , Ww          , Ww          , Ww          
Ww          , Ww          , Ds          , Dd          , Dd          , Dd          , Gs^Ft       , Gs^Ft       , Gs^Ft       , Gs^Ft       , Gs^Ft       , Gs^Ft       , Gs^Ft       , Dd^Do       , Gs^Ft       , Ds          , Ds          , Ww          , Ww          
Ww          , Ww          , Ww          , Dd          , Dd          , Dd          , Gs^Ft       , Gs^Ft       , Gs^Ft       , Gs^Ft       , Dd^Do       , Gs^Ft       , Dd^Do       , Gs^Ft       , Dd^Do       , Gs^Ft       , Ww          , Ww          , Ww          
Ww          , Ww          , Ww          , Dd          , Dd          , Gs^Ft       , Ds          , Gs^Ft       , Gs^Ft       , Gs^Ft       , Gs^Ft       , Dd^Do       , Gs^Ft       , Gs^Ft       , 1 Gs^Ft     , Ds          , Ds          , Ww          , Ww          
Ww          , Ww          , Ww          , Dd          , Dd          , Ds          , Ds          , Gs^Ft       , Ds          , Gs^Ft       , Ds          , Gs^Ft       , Ds          , Ds          , Ww          , Ds          , Ww          , Ww          , Ww          
Wo          , Ww          , Ww          , Ww          , Ww          , Ww          , Ww          , Ww          , Ww          , Ds          , Ww          , Ww          , Ww          , Ww          , Ww          , Ww          , Ww          , Ww          , Wo          
Wo          , Wo          , Wo          , Ww          , Wo          , Ww          , Ww          , Ww          , Ww          , Ww          , Ww          , Ww          , Wo          , Ww          , Wo          , Ww          , Wo          , Wo          , Wo          
Wo          , Wo          , Wo          , Wo          , Wo          , Wo          , Wo          , Wo          , Wo          , Wo          , Wo          , Wo          , Wo          , Wo          , Wo          , Wo          , Wo          , Wo          , Wo          
